{
	"size": [49, 49],
	"spawn": [24, 36],
	"img": {
		"unknown": "unknown",
		"paper": "paper",
		"writing": "writing",
		"exit": "exit"
	},
	"doors": {
		"0,128,0": [
			[1, 1],
			[2, 1],
			[3, 1],
			[4, 1],
			[6, 1],
			[7, 1],
			[8, 1],
			[9, 1],
			[10, 1],
			[11, 1],
			[12, 1],
			[13, 1],
			[14, 1],
			[15, 1],
			[16, 1],
			[17, 1],
			[18, 1],
			[19, 1],
			[20, 1],
			[21, 1],
			[22, 1],
			[23, 1],
			[24, 1],
			[25, 1],
			[26, 1],
			[27, 1],
			[28, 1],
			[29, 1],
			[1, 2],
			[29, 2],
			[1, 3],
			[29, 3],
			[1, 4],
			[29, 4],
			[1, 5],
			[29, 5],
			[1, 6],
			[29, 6],
			[1, 7],
			[29, 7],
			[1, 8],
			[29, 8],
			[1, 9],
			[27, 9],
			[28, 9],
			[29, 9],
			[1, 10],
			[27, 10],
			[1, 11],
			[27, 11],
			[1, 12],
			[27, 12],
			[1, 13],
			[1, 14],
			[27, 14],
			[1, 15],
			[28, 15, 1],
			[1, 16],
			[1, 17],
			[1, 18],
			[1, 19],
			[1, 20],
			[1, 21],
			[1, 22],
			[1, 23],
			[1, 24]
		],
		"0,128,1": [[5, 1, 1]],
		"255,0,0": [
			[14, 17, 1],
			[15, 43]
		],
		"0,255,128": [[27, 15]],
		"0,128,255": [
			[5, 16, 1],
			[13, 17],
			[11, 31],
			[10, 47]
		],
		"128,0,0": [
			[26, 15, 1],
			[23, 16],
			[32, 23]
		],
		"128,128,128": [[15, 17]],
		"255,255,255": [[16, 17]],
		"255,255,0": [
			[19, 20],
			[5, 24],
			[4, 25, 1],
			[6, 25, 1],
			[5, 26],
			[16, 31]
		],
		"0,255,255": [
			[15, 31, 1],
			[28, 35, 1],
			[8, 37],
			[10, 37]
		],
		"0,0,255": [
			[17, 31, 1],
			[5, 34]
		],
		"128,0,128": [
			[23, 32],
			[25, 32]
		],
		"0,255,0": [
			[9, 37, 1],
			[12, 41]
		],
		"254,0,0": [[19, 43]],
		"253,0,0": [[23, 43]],
		"252,0,0": [[27, 43, 1]],
		"251,0,0": [[31, 43, 1]],
		"255,128,0": [
			[41, 20],
			[34, 45]
		]
	},
	"buttons": {
		"5,5": [0, 128, 0],
		"5,10": [255, 255, 255],
		"27,13": [0, 255, 128],
		"11,15": [0, 128, 255],
		"17,17": [128, 0, 0],
		"19,19": [128, 128, 128],
		"27,19": [255, 128, 0],
		"3,22": [0, 255, 255],
		"5,22": [255, 255, 0],
		"7,22": [0, 255, 255],
		"1,25": [0, 128, 1],
		"5,28": [255, 255, 0],
		"31,31": [0, 0, 255],
		"1,37": [128, 0, 128],
		"13,43": [0, 255, 0],
		"15,47": [254, 0, 0],
		"19,47": [252, 0, 0],
		"23,47": [251, 0, 0],
		"27,47": [255, 0, 0],
		"31,47": [253, 0, 0]
	},
	"terrain": [
		"*************************************************",
		"*|||||||||||||||||||||||||||||*******************",
		"*|***************************|*******************",
		"*|*                         *|***         *******",
		"*|*                       8 *|***         *******",
		"*|*  _                      *|*             *****",
		"*|*               ***********|*             *****",
		"*|*               ***********|*             *****",
		"*|*********       ***********|*             *****",
		"*|*********           *****|||*             *****",
		"*|***_*****           *****|***             *****",
		"*|*     ***               *|*        9        ***",
		"*|*     *******           *|*       ***       ***",
		"*|*  7  *******           *_*       ***       ***",
		"*|*     *************     *|*     *******     ***",
		"*|*     ***_*********     |||     *******       +",
		"*|***|***** ***********|*************************",
		"*|*     ***  ||||_***** *************************",
		"*|*     *** *********** *************************",
		"*|*  6  *** *******_*** ***_                  ***",
		"*|*     *** *******|*** *****************|* 1 ***",
		"*|*     *** ******* *** *********     *   *   * *",
		"*|*_*_*_*** ******* *** *********     *** *** * *",
		"*|*** ***** ******* ***         |  5  *     * * *",
		"*|***|***** ******* *************     * ***** * *",
		"*_  | |           * *************     * *     * *",
		"*****|***** ***   * *************** *** * ***** *",
		"***** ***** ***   *     *********** *   *       *",
		"*****_***** ***   ***** *********** * ******* * *",
		"***     *** ***   ***** *       *** * *     * * *",
		"***     *** ***   ***** * ***** *** * * *** * * *",
		"***  4  ***|***|||***** * *****_*** *     *   * *",
		"***     *** ***   *****|*|********* * ******* * *",
		"***     *** ***   ***       ******* * *     *   *",
		"*****|***** ***   ***       ******* * * * * *****",
		"***     *** ***   ***       |       * * * *     *",
		"***     *** ***   ***       ********* *** * *** *",
		"*_   3  |||       ***               *     *   * *",
		"***     *** *********       ******* *********** *",
		"***     *** *   *****       ******* *           *",
		"***** ***** * 2 ******************* * ***********",
		"***** ***** |   ******************* * ***********",
		"***** ***** *********************** * ***********",
		"***** ***** *_ |   |   |   |   |    * ***       *",
		"***** ***** *********************** * ***       *",
		"***** *****                       | * ***      0*",
		"***** ***** **                   ** * ***     ***",
		"*****     | ***_***_***_***_***_***          ****",
		"*************************************************"
	],
	"messages": [
		"Hi there...",
		"Not bad",
		"Doing good so far",
		"Too easy?",
		"*insert something encouraging and inspiring*",
		"Sneaky...",
		"Pay attention...",
		"Keep going!",
		"Almost there!",
		"GG."
	],
	"finalMessage": "Game complete."
}
